000000000000000000000000000000
000000000000000000000000000000
000000000000000000000000000000
222200002200222222002200002222
110000001100111111001100000011
110000000000000000000000000011
000022000000000000000000220000
220022111111220022111111220022
220022000000000000000000220022
000000000000000000000000000000
333333004444444444444400333333
333333004444444444444400333333
000011000000002200000000110000
110011000000002200000000110011
110011222222002200222222110011
000000000000000000000000000000
555555555500001100005555555555
555555555500111111005555555555
000000002200000000002200000000
222211002222224422222200112222
222211002222224422222200112222
000011000000000000000000110000
110011001111113311111100110011
110011000000000000000000110011
000000000000000000000000000000
222222220022222222220022222222
222222220022222222220022222222
000000000000000000000000000000
555555555555555555555555555555
555555555555555555555555555555
000000000000000000000000000000
002222220000111111000022222200
002222220000111111000022222200
000000000000000000000000000000
000000000000000000000000000000
000010001000011110000100010000
000010001000016610000100010000
000010001000016610000100010000