000000000000000000000000000000
000000000000000000000000000000
000000000000000000000000000000
111100111100000000001111001111
111100111100000000001111001111
111100111100000000001111001111
111100111100000000001111001111
000000000000000000000000000000
111100111100111111001111001111
111100111100111111001111001111
111100111100111111001111001111
111100111100111111001111001111
000000000000000000000000000000
000000000000000000000000000000
000000111111222222111111000000
000000111111222222111111000000
000000111111222222111111000000
000000111111222222111111000000
000000000000000000000000000000
000000000000000000000000000000
001100111100000000001111001111
001100111100000000001111001111
001100000000000000000000001100
001100000000000000000000001100
001100002222222222222200001100
001100002222222222222200001100
001100000000000000000000001100
001100000000000000000000001100
001100111100000000000111111100
001100111100000000000111111100
000000000000000000000000000000
000000000000000000000000000000
001100110000000000000111111111
001100110000000000000111111111
000000110000111111000111111111
000000110000111111000000000000
001100110000116611000000000000
001100110000116611000000000000