000000000000000000000000000000
000000000000000000000000000000
000000000000000000000000000000
111100111100002200001111001111
111100111100002200001111001111
111100111100000000001111001111
000000000000111111000000000000
444444000044444444440000444444
444444000044444444440000444444
000000000000000000000000000000
110011112211000000112211110011
110011112211000000112211110011
000000000000111111000000000000
111100111100111111001111001111
222200222200000000002222002222
000000000000222222000000000000
111100111100222222001111001111
111100111100000000001111001111
000000000000111111000000000000
440044444400444444004444440044
440044444400444444004444440044
000000000000000000000000000000
110000111111000000001111001111
110000111111000000001111001111
000000000000222222000000000000
110000111100222222001111001111
110000111100000000001111001111
000000000000111111000000000000
110011110011111111110011110011
110011110011111111110011110011
000000000000000000000000000000
444400000000000000000000004444
444400111100000000001111004444
000000111100000000001111000000
000000000000011110000000000000
000000000000011110000000000000
000000000000116611000000000000
000000000000116611000000000000
