000000000000000000000000000000
000000000000000000000000000000
000000000000000000000000000000
444444400444444444004444444444
444444400444444444004444444444
000000000000000000000000000000
000000000000000000000000000000
444444444004444444440044444444
444444444004444444440044444444
000000000000000000000000000000
000000000000000000000000000000
000444444440044444444400444444
000444444440044444444400444444
000440000000000000000000000000
000440000000000000000000000000
000440044444400444444444004444
000440044444400444444444004444
000440044000000000000000000000
000440044000000000000000000000
000000044004444004444444440044
000000044004444004444444440044
000440000004400000000000000000
000440000004400000000000000000
000440044000000440044444444400
000440044000000440044444444400
000440044004400000000000000000
000440044004400000000000000000
000440044004400440000022222222
000440044004400440000000000022
000440044004400440000000000000
000000044004400440020000000000
000000044004400440020000000000
000440000004400440020000000000
000440000004400440020000000000
000440044000000440020000000000
000440044000000440020000000111
000440044004400000022000000166
000440044004400000022000000166