000000000000000000000000000000
000000000000000000000000000000
000000000000000000000000000000
111100003333000000003333000011
111100003333000000003333000011
000000000000001111000000000000
222200111100001111000011110022
222200111100000000000011110022
000000000000000000000000000000
444444000044444444444400004444
444444000044444444444400004444
000000000000002200000000000000
000000555555002200555555000000
001100555555000000555555001100
001100552255003300552255001100
001100552255003300552255001100
001100555555000000555555001100
001100555555002200555555001100
000000000000000000000000000000
000000000000000000000000000000
333333333333333333333333333333
333333333333333333333333333333
334444443344444444443344444433
334444443344444444443344444433
333333333333333333333333333333
333333333333333333333333333333
000000000000000000000000000000
000000000000000000000000000000
001100111111111111111111001100
001100111111111111111111001100
001100000000000000000000001100
001100000000000000000000001100
001100000000000000000000001100
000000000000000000000000000000
000000000000000000000000000000
000000000000011110000000000000
000000000000016610000000000000
000000000000016610000000000000