000000000000000000000000000000
000000000000000000000000000000
000000000000000000000000000000
110004444444440044444444400011
110004444444440044444444400011
000000000000000000000000000000
000000000000000000000000000000
000000000000000000000000000000
111100111100444444001111001111
111100111100444444001111001111
000000000000000000000000000000
000000000000000000000000000000
333333333300222222003333333333
333333333300222222003333333333
000000000000000000000000000000
000000000000000000000000000000
555555555555555555555555555555
555555555555555555555555555555
555555555555555555555555555555
555555555555555555555555555555
555555555555555555555555555555
000000000000000000000000000000
000000000000000000000000000000
002222002222000000222200222200
002222002222000000222200222200
000000000000000000000000000000
000000000000000000000000000000
001111003333001100333300111100
001111003333001100333300111100
000000000000000000000000000000
000000000000000000000000000000
001100440000000000000044001100
001100440000000000000044001100
000000440000011110000044000000
000000440000016610000044000000
001100440000016610000044001100
000000000000011110000000000000
000000000000000000000000000000