000000000000000000000000000000
000000000000000000000000000000
000000000000000000000000000000
444444400444444444004444444444
444444400444444444004444444444
000000000000000000000000000000
000000000000000000000000000000
444444444004444444440044444444
444444444004444444440044444444
000000000000000000000000000000
000000000000000000000000000000
004444444440044444444400444444
004444444440044444444400444444
004400000000000000000000000000
004400000000000000000000000000
004400444444400444444444004444
004400444444400444444444004444
004400440000000000000000000000
004400440000000000000000000000
000000440044444004444444440044
000000440044444004444444440044
004400000044000000000000000000
004400000044000000000000000000
004400440000004440044444444400
004400440000004440044444444400
004400440044000000000000000000
004400440044000000000000000000
004400440044004400000222222222
004400440044004400000000000022
004400440044004400000000000000
000000440044004400200000000000
000000440044004400200000000000
004400000044004400200000000000
004400000044004400200000000000
004400440000004400200000000000
004400440000004400200000000111
004400440044000000220000000166
004400440044000000220000000166