000000000000000000000000000000
000000000000000000000000000000
111111111111111111111111111100
111111111111111111111111111100
000000000000000000000000001100
000000000000000000000000001100
001111111111111111111111001100
001111111111111111111111001100
001100000000000000000011001100
001100000000000000000011001100
001100111111111111110011001100
001100111111111111110011001100
001100110000000000110011001100
001100110000000000110011001100
001100110011111100110011001100
001100110011111100110011001100
001100110011000000110011001100
001100110011000000110011001100
001100110011001111110011001100
001100110011001111110011001100
001100110011000000000011001100
001100110011000000000011001100
001100110011111111111111001100
001100110011111111111111001100
001100110000000000000000001100
001100110000000000000000001100
001100111111111111111111111100
001100111111111111111111111100
001100000000000000000000000000
001100000000000000000000000000
001111111111111111111111111111
001111111111111111111111111111
000000000000000000000000000000
000000000000000000000000000000
001111111000111111111111111111
001111111000111111111111111111
001111111000116611111111111111
001111111000116611111111111111