220000220000000000000022000011
220000220000000000000022000011
000000000000112211000000000000
333333220000112211000000223333
333333220000000000000000223333
333333000000000000000000333333
332200001111111111111100002233
332200001111111111111100002233
000000555555555555555555000000
000000555555555555555555000000
111100552200000000002255001111
111100552200000000002255001111
000000550000000000000055000000
000000550000000000000055000000
000022550000000000000055220000
000022550000000000000055220000
000000550000011110000055000000
000000550000016610000055000000
000000550000016610000055000000
000000550000011110000055000000
000022550000000000000055220000
000022550000000000000055220000
000000550000000000000055000000
000000550000000000000055000000
111100552200000000002255001111
111100552200000000002255001111
000000555555555555555555000000
000000555555555555555555000000
332200001111111111111100002233
332200001111111111111100002233
333333000000000000000000333333
333333000000000000000000333333
333333220000112211000022333333
000000220000112211000022000000
000000000000000000000000000000
000000000000000000000000000000
110000220000000000000022000011
110000220000000000000022000011