000000000000000000000000000000
000000000000000000000000000000
333333333333333333333333333333
333333333333333333333333333333
333333333333333333333333333333
333333333333333333333333333333
332222223322222222332222220033
332222223322222222332222220033
330000223300000000332200003333
330000223300000000332200003333
333333223333333333332233333333
333333223333333333332233333333
332222222222220022222222223333
332222222222220022222222223333
333333000000000000000033333333
333333000000000000000033333000
332222332222222222332222333000
332222332222222222332222333333
002200002200000022000022333333
002200002200000022000022000333
332233332233333322333322000333
332233332233333322333322333333
330003300000220000033000333333
330003300000220000033000333333
332222222233223322222222333333
332222222233223322222222333000
333333333333333333333333333000
333333333333333333333333333333
333333333333331133333333333333
330000011111111110000000333333
330000000000001100000000333333
330000000000000000000000333333
000000000000000000000000000000
002200000000000000000011111111
001100000000000000000011111111
001100000000011110000000000000
000011000000016610000000000000
000011000000016610000000000000