000000000000000000000011000000
000000000000000000000011000000
000000000000000000000011000000
222211000033333333000000002222
222211000033333333000000002222
000000000033333333111100000000
333000001111000000111100444444
330000001111000000111100444444
000022000000002222000000444444
111122005555552222555500000000
111100005555550000555500000000
000000005555550000555500111111
444444000000000022220000000000
444444001111000000000011110033
000000001111000000000011000033
555555000000004444000000000000
555555003333004444003333002222
000000003333001111003333002222
221122000000001661000000000000
221122000000001661000000111111
000000000000001111000000111111
333300555555555555555500000000
333300555555555555555500444444
000000000000000000000000444444
111100110022222200111111000000
111100110000002200110000000011
000000000000000000000000000011
222200444444005555550022220000
222200444444005555550022220000
000000000000005555550000000000
000000000000000000000000000000
000000003333333333330000000000
000000003333333333330000000000
001122000000000000000000221100
001122000110000000001100221100
000000000110000000000000000000
000000000110000000001100000000
000000000110000000001100000000