000000000000000000000000000000
000000000000000000000000000000
000000000000000000000000000000
001100111100111111001111001111
001100111100111111001111001111
001100111100111111001111001111
001100111100111111001111001111
000000000000000000000000000000
001100000000111111000000001111
001100000000111111000000001111
000000000000000000000000000000
001100111100111111001111001111
001100111100111111001111001111
000000000000000000000000000000
001100111100111111001111001111
001100111100111111001111001111
001100111100000000001111001111
001100111100000000001111001111
000000000000000000000000000000
000000000000000000000000000000
001111111111110011111001111100
001111111111110011111001111100
000000000000000011111001111100
000000000000000000000000000000
001100111100111111111001111111
001100111100111111111001111111
000000000000000000000000000000
000000000000000000000000000000
001100111100111111111001111111
001100111100111111111001111111
000000000000000000000002222222
001100111100000000000000000000
001100111100000000000000000000
001100111100111111112000000000
001100110000111111112000001111
001100110000111111112000001111
000000110000111111112000001166
000000110000111111112000001166