000000000003333333300000000000
000000000003333333300000000000
000000000003333333300000000000
333301111003333333300111103333
333301111003333333300111103333
333300000003333333300000003333
333333333333333333333333333333
333333333333333333333333333333
110011110033333333330011110011
110011110033333333330011110011
000000000011110011110000000000
333333330011110011110003333333
333333330000000000000003333333
333333330000000000000003333333
333330000022220022220000033333
333330110022220022220011033333
333330110000000000000011033333
333330000033333333330000033333
333333333333333333333333333333
333333333333333333333333333333
000000000033333333330000000000
111001110000000000000011110011
111001110022220022220011110011
000000000022220022220000000000
333333330000000000000033333333
333333330033333333330033333333
333333330033333333330033333333
000000000000000000000000000000
111001110022222222220011110011
111001110022222222220011110011
000000000000000000000000003333
333330000000000000000000003333
333330000000000000000011111111
333330000000000000000011111111
111110000000111111000011000000
111110000000111111000011000000
111110000000116611000011000000
111110000000116611000011000000