000000000000000000000000000000
000000000000000000000000000000
004444400444444444004444444444
004444400444444444004444444444
004444400444444444004444444444
004444400004444444000044444444
004444400004444444000044444444
004444444004444444440044444444
004444444004444444440044444444
000000000000044444440000444444
000000000000044444440000444444
004444444440044444444400444444
004444444440044444444400444444
004444444440000000000000004444
004444444440000000000000004444
004444444444400444444444004444
004444444444400444444444004444
004444444444400004444444000044
004444444444400004444444000044
000000044444444004444444440044
000000044444444004444444440044
004440000004400000044444440000
004440000004400000044444440000
004444444000000440044444444400
004444444000000440044444444400
004444444004400000000000000000
004444444004400000000000000000
004444444004444440044004440044
004444444004444440044004440044
004444444004444440000000000000
000000044004444440000000000000
000000044004444440044000000000
004440000004444440044000000000
004440000004444440044000000000
004444444000000440000000000011
004444444000000440000000000111
004444444444400000044000001166
004444444444400000044000001166