000000110000000000000011000000
000000110000000000000011000000
000000110000000000000011000000
003330000011111111110000033333
003330000011111111110000033333
000000222000000000000222000000
001100222003333333300000001111
001100000003333333300000001111
000000444444442244444400001111
001100444444442244444400001111
005555555555000000555555555555
005555555555000000555550000555
005522555522222222225550220555
005522555522222222225550220555
005555555555555555555550000000
000000000000111100000000000000
003333311100111100111233000000
003333311100000000111233000111
000000000022222222000200000166
004400444444444444400200000166
004400444444444444400200000111
000000000000000011000200000000
003003330000000011003230000000
003003330011111111003330000000
000000000000000000000000000000
005555555500000000555555555555
005555555522222222555555555555
000000000000000000000000000000
001111110000111100001111111111
001111110000111100001111111111
000000000000000000000000000000
005500555555555555555555005555
005500555555555555555555005555
001100111111111111111111001111
001100111111111111111111001111
000000000000000000000000000000
000000000000000000000000000000
000000000000000000000000000000