000000000000000000000000000000
000000000000000000000000000000
002002002002002200200200200200
002002002002002200200200200200
002002002000002200000200200200
002002002000002200000200200200
002002002002222222200200200200
002002002000000000000200200200
002002002000000000000200200200
002002002222002200222200200200
002000000000002200000000000200
002000000000002200000000000200
002002222002002200200222200200
000000002002002200200200000000
000000002002002200200200000000
002222002002002200200200222200
000002002000000000000200200000
000002002000000000000200200000
002002002000222222000200200200
000000000000000000000000000000
000000000000000000000000000000
002002002222002200222200200200
002000000002002200200000000200
002000000002002200200000000200
002002222002002200200222200200
000000002002002200200200000000
000000002002002200200200000000
002222002002002200200200222200
000002002002000000200200200000
000002002002000000200200200000
002002002000000000000200200200
002002002000000000000200200200
002002000000000000000000200200
002002000000000000000000200200
002000000000000000000000000200
002000000000011110000000000200
000000000000016610000000000000
000000000000016610000000000000