000000000000000000000000000000
000000000000000000000000000000
000000000000000000000000000000
111111110011111111001111111111
111111110011111111001111111111
110000000000000000000000000011
110000000000000000000000000011
110022001111002222111100220011
000011000000000000000000110000
110011000000000000000000110011
110011004444001100444400110011
110000004444001100444400110011
220022004444001100444400110011
000000000000000000000000000000
110011002222002200222200220011
330011002222002200222200220033
330011000000000000000000000033
000000001111111111111100110000
110000001111111111111100110011
110000000000000000000000000011
110022111100222222001111220011
110022111100222222001111220011
000011000000113311000000110000
110000000000003300000000000011
110000001100000000001100000011
001122001111002200111100221100
001122001111002200111100221100
000000000000000000000000000000
001111001111000000111100111100
001111000000000000000000111100
000000000000000000000000000000
000022000022222222220000220000
000022000000000000000000220000
000000000000000000000000000000
000000000000000000000000000000
000000020000011110000020000000
000000020000016610000020000000
000000020000016610000020000000