000011220011100001110022110000
000011220011100001110022110000
000000000000000000000000000000
220022111122002200221111220022
220022111122002200221111220022
000000000000000000000000000000
110000555555000000555555000011
110000555555444444555555000011
000000550000002200000055000000
333300550022222222220055003333
333300550022222222220055003333
000000000022000000220000000000
440044001111000000111100440044
440044001111000000111100440044
000000000000444444000000000000
221122003333000000333300221122
221122003333300003333300221122
000000003300011110003300000000
000000003300016610003300000000
000000003300016610003300000000
000000003300011110003300000000
221122003333300003333300221122
221122003333000000333300221122
000000000000444444000000000000
440044001111000000111100440044
440044001111000000111100440044
000000000022000000220000000000
333300550022222222220055003333
333300550022222222220055003333
000000550000002200000055000000
110000555555444444555555000011
110000555555000000555555000011
000000000000000000000000000000
220022111122002200221111220022
220022111122002200221111220022
000000000000000000000000000000
000011220011100001110022110000
000011220011100001110022110000