000000000000000000000000000000
000000000000000000000000000000
555555555555555555555555555555
111155111100000000001111551111
111155111100000000001111551111
555555555500222222005555555555
555555555500222222005555555555
111155111100000000001111551111
000055000000000000000000550000
555555555500111111005555555555
555555555500111111005555555555
555555555500000000005555555555
555555555555555555555555555555
555555555555555555555555555555
555522555555555555555555225555
555522555555555555555555225555
555555555500000000005555555555
555555555500222222005555555555
555555555500222222005555555555
555555555500000000005555555555
555555555555555555555555555555
555555555555555555555555555555
555555555555555555555555555555
555555555500000000005555555555
555522555511111111115555225555
555522555511111111115555225555
555555555500000000005555555555
555555555555555555555555555555
555555555555555555555555555555
000000000000000000000000000000
111100111100000000001111001111
111100111100000000001111001111
000000000000000000000000000000
555500000000000000000000005555
555500000000011110000000005555
555500000000011110000000005555
555500000000016610000000005555
555500000000016610000000005555