000000000000000000000000000000
000000000000000000000000000000
000000000000000000000000000000
111100111100002200001111001111
111100111100002200001111001111
111100111100000000001111001111
000000000000111111000000000000
444444000044444444440000444444
444444000044444444440000444444
000000000000000000000000000000
110000002211000000112200000011
110000002211000000112200000011
000000000000001100000000000000
111100111100001100001111001111
222200222200000000002222002222
000000000000222222000000000000
111100111100222222001111001111
111100111100000000001111001111
000000000000111111000000000000
440000444400444444004444000044
440000444400444444004444000044
000000000000000000000000000000
110000111100000000001111001111
110000111100000000001111001111
000000000000222222000000000000
110000111100222222001111001111
110000000000000000000000001111
000000000000111111000000000000
110000111111111111110011000011
110000111111111111110011000011
000000000000000000000000000000
444400000000000000000000004444
444400110000000000001111114444
000000110000000000001111110000
000000110000111111000000000000
000000110000111111000000000000
000000110000116611000000000000
000000110000116611000000000000