000000000000000000000000000000
000000000000000000000000000000
000000000000000000000000000000
001100111100111111001111001111
001100111100111111001111001111
001100111100111111001111001111
001100111100111111001111001111
000000000000000000000000000000
001100000000111111000000001111
001100000000111111000000001111
000000000000000000000000000000
001100111100111111001111001111
001100111100111111001111001111
000000000000000000000000000000
001100111100111111001111001111
001100111100111111001111001111
001100111100000000001111001111
001100111100000000001111001111
000000000000000000000000000000
000000000000000000000000000000
000111111111110011111111111000
000111111111110011111111111000
000000111100000000001111000000
000000111100000000001111000000
000000000000000000000000000000
111100000000111111001111111111
111100000000111111001111111111
000000000000000000000000000000
111100111100111111001111111111
111100111100111111001111111111
000000000000000000000000000000
001100111100000000000000000000
001100111100000000000000000000
001100111100000000000000000000
001100110000001100000000001111
001100110000111111110000001111
000000110000111111110000001166
000000110000111111110000001166