000000000000000000000000000000
000000000000000000000000000000
555555555555555555555555555555
555555555555555555555555555555
555555555555555555555555555555
555555555555555555555555555555
555555555555555555555555555555
555555555555555555555555555555
555555555555555555555555555555
555555555555555555555555555555
555555555555555555555555555555
555555555555555555555555555555
555555555550005500055555555555
500000055550200002055550000005
502220055550200002055550222205
500000055550222222055550000005
555555555550200002055555555555
555555555550205502055555555555
555555555550005500055555555555
555555555555555555555555555555
555555555555555555555555555555
555555500055555550000055555555
555555502055555550002055555555
555550002000555550002000555555
555550222220555550222220555555
555550002000555550002000555555
555555502055555555502055555555
555555500055555555500055555555
555555555555555555555555555555
555555555555555555555555555555
555555555550000000055555555555
555555555550222222055555555555
555555000000000000000000555555
555555000000000000000000555555
555555020000011110000020555555
555555020000016610000020555555
555555020000016610000020555555
555555020000011110000020555555