000000000000000000000000000000
000000000000000000000000000000
000000000000000000000000000000
111100111100002200001111001111
111100111100002200001111001111
000000000000000000000000000000
000000000000000000000000000000
444444000044444444440000444444
444444000044444444440000444444
000000000000000000000000000000
000000000000000000000000000000
000000002211000000112200000000
001100001100001100001100001100
001100111100001100001111001100
000000000000000000000000000000
000000000000000000000000000000
111100111100222222001111001111
111100111100004400001111001111
000000000000004400000000000000
000000000000004400000000000000
004400444444004400444444004400
004400444444004400444444004400
004400000000004400000000004400
004400000000004400000000004400
001100111100222222001111001100
001100111100222222001111001100
000000000000000000000000000000
000000000000000000000000000000
001100111111111111110011001100
001100111111111111110011001100
000000000000000000000000000000
000000000000000000000000000000
444400110000000000000011004444
444400110000000000000011004444
000000110000111111000011000000
000000110000111111000011000000
000000110000116611000011000000
000000110000116611000011000000