000000000000000000000000000000
000000000000000000000000000000
002200220022002200220022002200
002200220022002200220022002200
002200220022002200220022002200
002200220022002200220022002200
000000000000000000000000000000
000000000000000000000000000000
002200220022002200220022002200
002200220022002200220022002200
002200220022002200220022002200
002200220022002200220022002200
002200220022002200220022002200
002200220022002200220022002200
002200000022002200220000002200
002200000022002200220000002200
002222000000002200000000222200
002222000000002200000000222200
002200002200000000002200002200
002200002200000000002200002200
000000220000220022000022000000
000000220000220022000022000000
002200000022000000220000002200
002200000022000000220000002200
002200220000002200000022002200
002200220000002200000022002200
002200220022002200220022002200
002200220022002200220022002200
002200220022000000220022002200
002200220022000000220022002200
002200220000000000000022002200
002200220000000000000022002200
002200220000011110000022002200
002200220000116611000022002200
002200000000116611000000002200
002200000000011110000000002200
000000000000000000000000000000
000000000000000000000000000000