000000000000000000000000000000
000000000000000000000000000000
000000000000000000000000000000
000111001001001110010010000000
000101001001001010011010000000
000111001001001110010110000000
000101001001001010010010000000
000101000110001010010010000000
000000000000000000000000000000
444400004444444444444400044400
444400004444444444444400044400
000000000000000000000000000000
333333333333333333333333333333
000000000000000000000000000000
011001001110101011101010000000
100101000100101010001110000000
101101000100111011101010000000
100101000100101010001010000000
011101001110101011101010000000
000000000000000000000000000000
555555555555555555555555555555
555555555555555555555555555555
000000000000000000000000000000
220001111100000000001111100022
220001111100000000001111100022
000000000000222222000000000000
000000000000222222000000000000
001100111100333333001111011100
001100111100333333001111011100
000000000000000000000000000000
000000000000000000000000000000
001111001111100001111100111100
001111001111100001111100111100
000000000000000000000000000000
000000000000000000000000000000
000000000000011110000000000000
000000000000016610000000000000
000000000000016610000000000000