000000000000000000000000000000
000000000000000000000000000000
000000000000000000000000000000
444400000011111111100000004444
444400000011111111100000004444
444400220000000000000022004444
444400220011000001100022004444
000000000011000001100000000000
000000000000000000000000000000
444444001111111111111100444444
444444001111111111111100444444
444444000000000000000000444444
444444000000000000000000444444
000000002222000022220000000000
000000002222000022220000000000
111100000000000000000000001111
111100444444444444444400001111
000000444444444444444400000000
000000000000000000000000000000
000000001111111111110000000000
444444001111111111110044444444
444444000000000000000044444444
444444000000000000000044444444
000000002222222222220000000000
000000002200000000220000000000
000000000000000000000000000000
000000000000000000000000000000
000044444444444444444444440000
000044444444444444444444440000
000000000000000000000000000000
000000000000000000000000000000
000000000000000000000000000000
000000000000000000000000000000
220000000000111111110000000022
220000000000166111110000000022
000000000000166111110000000000
000000000000111111110000000000
000000000000111111110000000000